"a" = (/turf/inv,/area)

(1,1,1) = {"
aaaaa
aaaaa
aaaaa
aaaaa
aaaaa
"}
